
NO	./textures/jo1.xpm  
     
SO ./textures/jo2.xpm

WE ./textures/chad.xpm

EA ./textures/jo3.xpm    

F 0,45,0

C 225,34,1




11111111111111111111
10000000000000000001
10111111111111111001
10101010111010101001
10101010101010101001
10101010111010101001
10101010101010101001
10101010101010101001
10101010101010101001
10101010101010101001
1010101S101010101001
10100000000000000001
10111111111111111001
10000000000000000001
11111111111111111111