
NO	./textures/NO.xpm  
     
SO ./textures/SO.xpm

WE ./textures/WE.xpm

EA ./textures/EA.xpm    

F 0,100,0

C 225,30,1




11111111111111111111
10000000000000000001
10111111111111111001
10100000000000001001
10101111111111101001
10101000000000101001
10101011111110101001
10101010000010101001
10101010111010101001
1010101011E010101001
10101010111010101001
10101010101010101001
10101010101010101001
10101010101010101001
10101010101010101001
10101010101010101001
10100000000000000001
10111111111111111001
10000000000000000001
11111111111111111111