
NO	./textures/NO.xpm  
     
SO ./textures/SO.xpm

WE ./textures/WE.xpm

EA ./textures/EA.xpm    

F 0,100,0

C 225,30,1




    11111111111111
    10000001001111
    10000001001001
    100000001001001
    10E000001001001
    100000001001001
    100000001001001
    10000001001001
    10000001001001
    10000001001001
    10000001001001
    11111111111111