
NO	./textures/NO.xpm  
     
SO ./textures/SO.xpm

WE ./textures/WE.xpm

EA ./textures/EA.xpm    

F 0,100,0

C 225,30,1




    1111111
    10000N1
     1000001
    1000001
    1111111