

SO	./textures/NO.xpm
     
NO ./textures/SO.xpm

WE ./textures/WE.xpm

EA ./textures/EA.xpm    

F 0,100,0

C 225,30,1






        11111111111111111111111111           
        1000000000110000000000001        
        1011000001110000000000001
        1001000000000000000000001
111111111011000001110000000000001
100000000011000001110111111111111 
11110111111111011100000010001
11110111111111011101010010001
110000001101010111000N0010001
10000000000000001100000010001
10000000000000001101010010001
10000001110101011111011110N0111
10110111 1110101 101111010001
10111111 1110111 111111111111
100001
100001
100001
1011111111111111111110011111
1000000000000000000000000001
1111111111111111111111111111
