

NO	./textures/NO.xpm

SO	./textures/SO.xpm

WE ./textures/WE.xpm
EA ./textures/EA.xpm    


C 225,30,1
F 80,40,5


                        111111
                        1001          
                        1001          
        1111111111111111111111111
        1000000000110011110000001
        101100000111000W10000001
        1001000000000011110000001
111111111011000001110000000000001
100000000011000001110111111111111
11110111111111011100000010001
11110111111111011101010010001         
11000000110101011100001100001    
10000000000000001100001110001
1000000000000000110101010001   
1100000111010101111101111000111
11110111 1110101 101111010001
11111111 1111111 100000000001
                 111111111111 