

SO	./textures/NO.xpm
     
NO ./textures/SO.xpm

WE ./textures/WE.xpm

EA ./textures/EA.xpm    

F 0,100,0

C 225,30,1




11111111111111111
10000000000000001
111111111111111111111111111111111
        1000000000110000000000001
        1011000001110000000000001
        1001000000000000000000001
111111111011000001110000000000001
100000000011000001110111111111111  
111101111111110111000000100N1
11110111111111011101000010001
11000000110101011100000010001
10000000000000001100000010001
10000000000000001101010010001
1100000111010101111101111000111
11110111 1110101 101111010001
11111111 1111111 100000000001
                 111111111111
