

NO	./textures/NO.xpm

SO	./textures/SO.xpm

WE ./textures/WE.xpm
EA ./textures/EA.xpm    


C 225,30,1
F 80,40,5


                        111111
                        1001          
                        1001          
        111111111111111111111
        100000000011001111001
        101100000111000W1001
        100100000000001111001
11111111101100000111000000001
10000000001100000111011111111
11110111111111011100000010001
11110111111111011101010010001         
11000000110101011100001100001    
10000000000000001100001110001
1000000000000000110101010001   
11000001110101011111011110001
11110111 1110101 101111010001
11111111 1111111 100000000001
                 111111111111 